A: B
B: c
C: L
D: M
E: Q
F: N
G: D
H: i
I: X
J: m
K: n
L: I
M: o
N: F
O: T
P: a
Q: C
R: H
S: p
T: v
U: j
V: k
W: V
X: P
Y: l
Z: f
a: z
b: w
c: e
d: U
e: h
f: s
g: G
h: y
i: E
j: d
k: Y
l: t
m: J
n: O
o: q
p: S
q: W
r: R
s: r
t: b
u: x
v: A
w: u
x: K
y: g
z: Z
