A: M
B: n
C: V
D: d
E: X
F: é
G: h
H: u
I: F
J: L
K: A
L: J
M: O
N: R
O: í
P: b
Q: S
R: ő
S: ö
T: p
U: Ó
V: Ú
W: I
X: r
Y: G
Z: m
a: c
b: Ő
c: á
d: E
e: Y
f: o
g: Z
h: Q
i: j
j: B
k: ű
l: g
m: T
n: t
o: q
p: H
q: i
r: x
s: a
t: Ü
u: Ű
v: C
w: N
x: f
y: É
z: ó
Á: v
É: e
Í: y
Ó: U
Ö: D
Ú: Ö
Ü: l
á: z
é: s
í: k
ó: Á
ö: Í
ú: w
ü: W
Ő: K
ő: P
Ű: ú
ű: ü
