A: E
B: Q
C: c
D: J
E: t
F: K
G: s
H: A
I: N
J: w
K: e
L: h
M: X
N: P
O: V
P: f
Q: F
R: L
S: m
T: y
U: Y
V: u
W: p
X: i
Y: S
Z: a
a: M
b: B
c: r
d: q
e: k
f: z
g: C
h: b
i: G
j: g
k: W
l: D
m: x
n: o
o: v
p: I
q: l
r: O
s: T
t: H
u: n
v: d
w: j
x: R
y: Z
z: U
