A: B
B: t
C: Q
D: p
E: j
F: ő
G: D
H: C
I: u
J: á
K: Ó
L: w
M: S
N: i
O: E
P: I
Q: Ő
R: X
S: Í
T: U
U: ó
V: é
W: c
X: Á
Y: a
Z: ű
a: K
b: R
c: ú
d: k
e: l
f: s
g: V
h: m
i: h
j: v
k: y
l: P
m: T
n: g
o: F
p: ö
q: Ú
r: J
s: ü
t: z
u: e
v: q
w: N
x: G
y: o
z: í
Á: x
É: Z
Í: Ű
Ó: b
Ö: É
Ú: d
Ü: M
á: Ü
é: n
í: L
ó: r
ö: W
ú: Ö
ü: A
Ő: H
ő: f
Ű: Y
ű: O
