A: A
B: X
C: M
D: o
E: t
F: l
G: W
H: R
I: n
J: q
K: J
L: h
M: f
N: g
O: U
P: y
Q: N
R: D
S: S
T: w
U: V
V: G
W: m
X: e
Y: b
Z: Q
a: T
b: j
c: O
d: i
e: s
f: L
g: F
h: z
i: E
j: v
k: Y
l: I
m: C
n: H
o: r
p: p
q: B
r: Z
s: P
t: d
u: u
v: k
w: x
x: c
y: K
z: a
