A: V
B: Z
C: B
D: W
E: a
F: r
G: L
H: I
I: y
J: o
K: m
L: A
M: O
N: j
O: E
P: b
Q: S
R: v
S: Q
T: Y
U: D
V: P
W: e
X: G
Y: q
Z: k
a: M
b: R
c: U
d: x
e: n
f: u
g: w
h: X
i: t
j: N
k: c
l: H
m: h
n: d
o: T
p: g
q: p
r: C
s: K
t: z
u: F
v: i
w: J
x: s
y: l
z: f
