A: R
B: e
C: n
D: v
E: F
F: h
G: X
H: K
I: U
J: G
K: k
L: q
M: J
N: s
O: V
P: Z
Q: i
R: p
S: T
T: y
U: o
V: P
W: u
X: D
Y: j
Z: B
a: m
b: w
c: d
d: f
e: l
f: M
g: S
h: W
i: E
j: Y
k: N
l: O
m: z
n: c
o: r
p: A
q: C
r: Q
s: x
t: t
u: a
v: L
w: H
x: b
y: I
z: g
